#.##################
#..................#
#.a................#
#.....a............#
............s.......
#..................#
####################
#..................#
#....a.............#
#........a.........#
#..................#
#..................#
#.################## 
