#############
#...........#
#a.a.a......#
#aaa.a......#
#a.a.a...s..# 
#############