###################################
#.................................#
#..a..a............#....###.......#
#....................####f.....a..#
#..a............a.........#.......#
#.........s.......................#
#............a.......a............#
#.....a...........................#
#################################.#
#..a.....a............a...........#
#...#...a.........................#
###################################